Oppidum et musée archéologique d'Ensérune -> Oppidum d'Ensérune
Village fortifié de Mont-Dauphin -> Fort du Mont-Dauphin
Château et remparts de la Cité de Carcassonne -> Cité de Carcassonne
Chapelle des moines de Berz-la-Ville -> Chapelle des moines de Berzé-la-Ville
Tours de La Rochelle -> La Rochelle
Cité internationale de la langue française - château de Villers-Cotterêts -> Cité internationale de la langue française
Maison et jardins de Georges Clemenceau -> Maison de Georges Clemenceau
Ensemble cathédrale du Puy-en-Velay -> Cathédrale Notre-Dame du Puy-en-Velay
Tours de la cathédrale de Reims -> Cathédrale Notre-Dame de Reims
Château ducal de Cadillac -> Château de Cadillac
Cloître de la cathédrale de Bayonne -> Cathédrale Sainte-Marie de Bayonne
Tours et remparts d’Aigues-Mortes -> Remparts d'Aigues-Mortes
Trésor de la cathédrale de Lyon -> Primatiale Saint-Jean de Lyon
Site archéologique de Montcaret -> Montcaret
Crypte et tour de la cathédrale de Bourges -> Cathédrale Saint-Étienne de Bourges
Sites et musée archéologiques de Montmaurin -> Arc de triomphe de l'Étoile
Site archéologique de Glanum -> Glanum
Domaine national du château de Coucy -> Château de Coucy
Cloître de la cathédrale de Fréjus -> Cathédrale Saint-Léonce de Fréjus
Site gallo-romain de Sanxay -> Site antique de Sanxay
Domaine national du Palais-Royal -> Palais-Royal
Mosquée El-Fath -> Liste de mosquées de France
Centre Pompidou - Musée National d'Art Moderne -> Musée national d'Art moderne
Église Albert le Grand -> Albert le Grand
Église Réformée de Passy Annonciation -> Église protestante unie de Paris Passy-Annonciation
Église Saint-Serge -> Institut Saint-Serge
Eglise Suédoise (Svenska Kirkan) -> Sven Lagerbring
Pavillon Paul Delouvrier -> Parc de la Villette
Musée Guimet (Musée National des Arts Asiatiques) -> Musée national des Arts asiatiques - Guimet
Salle Saint Bruno -> Bruno de La Salle
Street Art - Rue Dénoyez -> Art urbain à Paris
Espace Culturel Louis Vuitton -> LVMH - Moët Hennessy Louis Vuitton
Paroisse Saint François de Molitor -> Église Saint-François de Molitor
Au coeur des Batignolles -> 17e arrondissement de Paris
Institut Suédois | Svenska Institutet i Paris -> Lennart Nilsson
La Maison D'emile Zola -> Maison d'Émile Zola
Temple de Ganesh -> Bhaktapur
Tombe de Jim Morrison -> Jim Morrison
Tombe d'Edith Piaf -> Édith Piaf
Square de la Baleine -> Square Saint-Éloi
Temple KAGYU DZONG -> Kagyu-Dzong
Square Martin Nadaud -> Rue Sorbier
Jardin Du Carré Baudouin -> Jardin Carré-de-Baudouin
L'Espace des Blancs-Manteaux -> Blancs-Manteaux
Paroisse Notre Dame de Grace de Passy -> Église Notre-Dame-de-Grâce de Passy
Chapelle Sainte Thérèse -> Chapelle Sainte-Thérèse de Montmagny
Carrefour Numérique -> Cité des sciences et de l'industrie
La Faluère -> René Lefebvre de La Faluère
Jardins Pereire -> Frères Pereire
Les Jardins de Roland Garros -> Stade Roland-Garros
Fondation Louis Vuitton (chantier) -> Fondation d'entreprise Louis-Vuitton
La Chapelle Sainte Rita -> Rita de Cascia
Square Rodin -> Lycée Rodin
Eglise Armenienne du Marais -> Cathédrale Sainte-Croix de Paris des Arméniens
Place de Rhin et Danube -> Place Rhin-et-Danube
Place Wagram -> Place de Wagram
Laureline's Garden -> Animation Digital Network
Escaliers de Lamarck-Caulaincourt -> Lamarck - Caulaincourt (métro de Paris)
Pont Qui Bouge -> Tizi Ouzou
FRAC Île-de-France — Le Plateau -> Conseil régional d'Île-de-France
L'Eglise Notre-Dame de Consolation -> Chapelle Notre-Dame-de-Consolation de Paris
Pelouse aux Lions -> Équipe du Cameroun de football
Place de la Convention -> Convention citoyenne pour le climat
Jardin des Invalides -> Hôtel des Invalides
Jardin de la Cité Prost -> Cité Prost
Rond-Point des Champs-Élysées — Marcel Dassault -> Rond-point des Champs-Élysées-Marcel-Dassault
statue d'Artagnan -> D'Artagnan
Église Notre-Dame de la Croix -> Église Notre-Dame-de-la-Croix de Ménilmontant
Daso -> Arnold Kisoka
Hillsong Paris -> Église Hillsong
Le jardin de bagnolet -> Bagnolet
Paroisse Notre-Dame du Liban -> Notre-Dame du Liban
Parc de la Folie-Titon -> Rue Titon
Galerie Itinerrance -> Shepard Fairey
Jardin d’Éole -> Jardins d'Éole
Pont De Caulaincourt -> Pont Caulaincourt
Le Mur des "Je t'aime" -> Je t'aimais, je t'aime, je t'aimerai
Eglise Evangelique Protestante -> Protestantisme
L'église Af83 -> Églises afro-américaines
Couvent Dominicain De St Jacques -> Jacques Fontaine (dominicain)
Square Passy -> 16e arrondissement de Paris
Cité-Refuge De L'Armée Du Salut Le Corbusier -> Le Corbusier
Parc de la Cité Internationale Universitaire -> Cité internationale universitaire de Paris
Temple Boudhiste -> Temple bouddhiste
Eglise Du Sacré Coeur Colombes -> Sacré-Cœur de Jésus
Square Du Jeu De Boules -> Drakengard (jeu vidéo)
Passerelle Des Meuniers -> Rue des Meuniers
Eglise Orthodoxe de Saint-Seraphin-de-Sarov -> Séraphin de Sarov
Quais de Jussieu -> Campus Pierre-et-Marie-Curie (Jussieu)
Centre Paroissial -> Œuvre des Chantiers du Cardinal
Notre-Dame D'Espérance -> Basilique Notre-Dame-d'Espérance de Charleville-Mézières
Les Maisons Rouges -> Maison-Rouge
Centre de Loisir Vincennes Nogent -> Nogent-sur-Marne
Église Saint-Gabriel -> Église Saint-Gabriel de Paris
Mosquée Omar Ibn El Khattab -> Omar ibn al-Khattâb
Esplanade de la Bibliothèque Nationale de France -> Bibliothèque nationale de France
Paroisse Saint Hippolyte -> Ancienne église Saint-Hippolyte de Paris
La Cheminee Noire -> Sur les chemins noirs (livre)
Square Trébois -> Rue Jean-Jaurès (Levallois-Perret)
Le Tabernacle -> Tabernacle (Bible)
Église Des Soldats -> Tombeau de Napoléon Ier aux Invalides
Carrefour Saint-Placide/Rennes -> Rue de Rennes (Paris)
Statue Charles de Gaulle -> Statue Charles de Gaulle à Varsovie
Le Château D'Ingres -> Jean-Auguste-Dominique Ingres
Parc Avenue Foch -> Ferdinand Foch
Mosquee Foyer gergovie -> Liste des mosquées de Paris
Chapelle Notre-Dame du Saint-Sacrement -> Chapelle Notre-Dame-du-Saint-Sacrement de Paris
Église Protestante Évangélique des Ternes -> 17e arrondissement de Paris
La Juma'a -> Coupe arabe des nations de football 1998
statue de La Fontaine -> Fontaine de Trevi
Jardin Botanique du Jardin des Plantes -> Jardin des plantes de Paris
Church Baptist -> Baptisme
Temple bouddhiste de l’association des Teochew de France -> Quartiers asiatiques de Paris
Parc des portes de Paris -> Parc Disneyland (Paris)
La Maison des Canaux -> La Maison du canal
Passerelle Arts Et Metiers -> Art déco
La Splendens Factory -> La Révélation des Pyramides
Parc Marmottan -> Musée Marmottan Monet
Place du Générale Leclerc -> Philippe Leclerc de Hauteclocque
Jardin des Meuniers -> Jardin botanique de Bruxelles
Musée d'Art Moderne (MAM) -> Musée d'Art moderne
Les Salons Venitiens -> Musée des Arts forains
Appartements D'Edith Piaff -> Édith Piaf
Loge Maçonnique Droit Humain -> Loge maçonnique
2eme -> Le Parrain, 2e partie
Eglise Danoise (Danske Kirke) -> Charlie Kirk
Deuxième Eglise De La Science Chrétienne , Paris -> Science chrétienne
Aerys -> Maison Targaryen
Maison La Roche / Lecorbusier -> Le Corbusier
B.L.O.C -> Liste de sigles de trois caractères
Circulation(s), Festival de la Jeune Photographie Européenne -> Centquatre-Paris
Hillsong Paris -> Église Hillsong
Pauline's sofa -> Le Daron
Cemetière de Mont Martre -> Jaligny-sur-Besbre
Eglise Catholique Russe de la Très-Sainte Trinité -> Église catholique russe de la Très-Sainte-Trinité de Paris
Chapelle de l'hôpital St. Louis -> Louis XIV
Mosquée Porte des Poissonniers -> 18e arrondissement de Paris
Grand Pelouse CIUP -> Glassbox
Le Panteon -> Panteón Rococó
Église Évangélique de Télégraphe -> Églises de maison chinoises
Abbaye Sainte-Marie de La Source -> Abbaye Sainte-Marie de Valmagne
La Roseraie - Parc de Bagatellle -> Roseraie de Bagatelle
Булонский Лес -> Булонский лес
Sous Un Arbre ! -> Rosiers sous les arbres
La Petite Ceinture -> Ligne de Petite Ceinture
Église Impulsion -> Phobie d'impulsion
Mylene's Appartment -> Mylène Farmer
L'Atelier De La Charpenterie -> Ateliers Perrault
Aux Petits Annes du Ranelagh -> Jardin du Ranelagh
Eglise de Scientologie - Celebrity Center -> Scientologie
Arco do Triunfo -> FC Porto
Rue Thibault -> Rue des Bourdonnais
